10
15
XXXXXXXXXXXXXXX
X  . X        X
X        .    X
X             X
XXXXXXXXXX    X
X.  .         X
X      X      X
X      X.     X
X             X
XXXXXXXXXXXXXXX

